########
#......#
#..B..X#
#P.....#
########