..####...
###..####
#.....B.#
#.#..#B.#
#.X.X#P.#
#########