..#####.
###...#.
#XPB..#.
###.BX#.
#X##B.#.
#.#.X.##
#B.YBBX#
#...X..#
########